1111111
10C0P11
1010101
1000111
1100111
10E0C01
1111111
