1111111
1EC0P11
1010101
1000111
1100111
10E0C01
1111111
