111111111111111111111111111
1EC0P1000000C000000001C0001
101000100000000000C00000C01
100000000000000000000000001
110000000000C00000000000001
10E0C000000000000C000000001
111111111111111111111111111
